box_number,box_code,box_name,eligible_voters,valid_votes,invalid_votes,total_votes,male_voted,female_voted,candidate_1_votes,candidate_2_votes,candidate_3_votes,candidate_4_votes,candidate_5_votes,candidate_6_votes,candidate_7_votes,candidate_8_votes,verified
A01,A01.01.1,1 | Ha. Thuraakunu - 1,361,288,9,297,150,147,1,0,140,146,0,1,0,0,1
A01,A01.02.1,2 | Ha. Uligamu - 1,291,207,3,210,110,100,2,0,86,113,3,0,3,0,1
A01,A01.04.1,4 | Ha. Hoarafushi - 1,517,420,20,440,211,229,10,1,240,158,6,1,4,0,1
A01,A01.04.2,5 | Ha. Hoarafushi - 2,464,372,9,381,192,189,5,0,171,180,6,0,8,2,1
A01,A01.04.3,6 | Ha. Hoarafushi - 3,402,317,5,322,164,158,2,2,158,148,1,0,6,0,1
A02,A02.03.1,3 | Ha. Molhadhoo - 1,206,179,11,190,84,106,1,0,132,39,4,0,3,0,1
A02,A02.05.1,7 | Ha. Ihavandhoo - 1,664,581,12,593,261,332,14,0,273,273,1,1,15,4,1
A02,A02.05.2,8 | Ha. Ihavandhoo - 2,619,552,7,559,250,309,11,0,219,288,4,0,26,4,1
A02,A02.05.3,9 | Ha. Ihavandhoo - 3,534,462,11,473,217,256,4,2,241,182,0,0,32,1,0
A02,A02.10.1,18 | Ha. Maarandhoo - 1,466,394,3,397,190,207,3,0,195,159,2,0,5,30,1
A03,A03.11.1,19 | Ha. Thakandhoo - 1,263,223,3,226,113,113,2,0,88,83,0,0,50,0,1
A03,A03.12.1,20 | Ha. Utheemu - 1,487,425,2,427,193,234,12,1,191,213,2,0,6,0,1
A03,A03.13.1,21 | Ha. Muraidhoo - 1,385,340,5,345,148,197,0,0,153,159,0,1,27,0,1
A03,A03.14.1,22 | Ha. Baarah - 1,408,315,18,333,152,181,2,0,151,146,3,1,12,0,1
A03,A03.14.2,23 | Ha. Baarah - 2,412,346,2,348,147,201,4,1,169,152,1,1,11,7,1
A04,A04.08.1,13 | Ha. Dhidhdhoo - 1,437,368,3,371,175,196,4,0,165,160,6,2,31,0,1
A04,A04.08.2,14 | Ha. Dhidhdhoo - 2,498,422,5,427,178,249,7,0,151,230,11,0,22,1,1
A04,A04.08.3,15 |Ha. Dhidhdhoo - 3,610,480,18,498,208,290,3,0,191,192,10,1,83,0,1
A04,A04.08.4,16 | Ha. Dhidhdhoo - 4,590,474,20,494,234,260,11,0,185,209,4,3,58,4,1
A05,A05.06.1,10 |Ha. Kelaa - 1,419,291,26,317,144,173,5,1,113,154,6,0,12,0,1
A05,A05.06.2,11 | Ha. Kelaa - 2,325,238,5,243,125,118,6,1,100,123,4,0,3,1,1
A05,A05.07.1,12 | Ha. Vashafaru - 1,432,369,5,374,175,199,1,0,125,228,6,0,9,0,1
A05,A05.09.1,17 | Ha. Filladhoo - 1,443,357,6,363,177,186,1,0,153,190,2,1,10,0,1
AT.,AT.1.1,"492  | HA. Atoll, Male' - 1",853,731,4,735,347,388,7,0,277,375,34,8,28,2,1
AT.,AT.1.2,"493 | HA. Atoll, Male' - 2",822,686,11,697,376,321,42,0,257,346,3,5,26,7,1
AT.,AT.3.1,"495 | HA. Atoll, Male' - 4",426,374,2,376,178,198,12,0,121,181,4,3,51,2,1
AT.,AT.3.2,"496 | HA. Atoll, Male' - 5",587,499,4,503,264,239,19,0,153,286,4,0,29,8,1
AT.,AT.4.1,"497 | HA. Atoll, Male' - 6",631,536,8,544,300,244,26,1,166,282,4,6,46,5,1
AT.,AT.5.1,"498 | HA. Atoll, Male' - 7",700,577,6,583,304,279,31,1,206,288,4,13,34,0,1
AT.,AT.5.2,"499 | HA. Atoll, Male' - 8",439,347,1,348,166,182,5,0,89,208,7,10,27,1,1
B01,B01.01.1,24 | Hdh. Hanimaadhoo - 1,772,588,18,606,289,317,13,1,303,188,51,1,26,5,1
B01,B01.01.2,25 | Hdh. Hanimaadhoo - 2,576,454,29,483,235,248,17,1,231,160,29,5,4,7,1
B01,B01.02.1,26 | Hdh. Finey - 1,284,252,10,262,109,153,10,0,136,91,10,1,1,3,1
B01,B01.03.1,27 | Hdh. Naivaadhoo - 1,356,307,9,316,135,181,2,0,155,142,3,3,2,0,1
B01,B01.04.1,28 | Hdh. Hirimaradhoo - 1,292,225,3,228,100,128,0,0,85,119,12,4,5,0,1
B02,B02.05.1,29 | Hdh. Nolhivaranfaru - 1,512,360,16,376,147,229,5,2,157,164,11,4,2,15,1
B02,B02.05.2,30| Hdh. Nolhivaranfaru - 2,420,324,3,327,143,184,3,0,131,170,5,0,4,11,1
B02,B02.07.1,32 | Hdh. Nolhivaramu -1,689,446,17,463,198,265,21,0,113,284,7,6,12,3,1
B02,B02.07.2,33 | Hdh. Nolhivaramu - 2,758,503,10,513,201,312,16,1,167,248,10,14,43,4,1
B03,B03.06.1,31 | Hdh. Nellaidhoo - 1,729,545,57,602,279,323,21,1,274,193,15,1,34,6,1
B03,B03.08.1,34 | Hdh. Kurinbi  -1,431,349,4,353,154,199,16,0,163,167,0,0,3,0,1
B03,B03.12.1,46 | Hdh. Vaikaradhoo - 1,361,269,5,274,130,144,7,1,184,64,1,1,10,1,1
B03,B03.12.2,47 | Hdh. Vaikaradhoo - 2,222,137,13,150,73,77,2,0,91,40,2,0,2,0,1
B04,B04.09.1,35 | Hdh. Kulhudhuffushi - 1,775,514,16,530,251,279,55,4,182,217,12,5,34,5,1
B04,B04.09.2,36 | Hdh. Kulhudhuffushi - 2,876,637,9,646,285,361,75,0,189,320,3,11,35,4,1
B04,B04.09.3,37 | Hdh. Kulhudhuffushi - 3,650,444,6,450,206,244,50,0,134,220,1,9,29,1,1
B04,B04.09.4,38 | Hdh. Kulhudhuffushi - 4,713,496,13,509,228,281,54,1,192,207,6,4,32,0,1
B05,B05.09.1,39 | Hdh. Kulhudhuffushi - 5,1007,725,16,741,344,397,63,1,224,387,5,6,37,2,1
B05,B05.09.2,40 | Hdh. Kulhudhuffushi - 6,239,204,2,206,84,122,13,0,91,91,1,0,8,0,0
B05,B05.09.3,41 | Hdh. Kulhudhuffushi - 7,420,275,6,281,117,164,28,0,93,128,8,7,10,1,0
B05,B05.09.4,42 | Hdh. Kulhudhuffushi - 8,576,373,3,376,163,213,49,0,118,179,2,1,23,1,0
B05,B05.09.5,43 | Hdh. Kulhudhuffushi - 9,884,630,8,638,271,367,53,1,220,295,16,8,37,0,0
B06,B06.10.1,44 | Hdh. Kumundhoo - 1,842,570,37,607,257,350,13,1,259,239,4,1,52,1,0
B06,B06.11.1,45 | Hdh. Neykurendhoo - 1,537,348,33,381,176,205,13,2,187,116,6,0,24,0,0
B06,B06.13.1,48 | Hdh. Makunudhoo - 1,470,359,27,386,188,198,2,2,152,163,2,5,12,21,0
B06,B06.13.2,49 | Hdh. Makunudhoo - 2,408,317,9,326,164,162,1,1,129,134,3,1,27,21,0
BT.,BT.1.1,"500 | HDH. Atoll, Male' - 1",428,335,1,336,183,153,21,0,127,153,6,10,17,1,1
BT.,BT.2.1,"501 | HDH. Atoll, Male' - 2",536,394,5,399,206,193,26,0,108,223,6,11,20,0,1
BT.,BT.3.1,"502 | HDH. Atoll, Male' - 3",602,476,5,481,279,202,30,0,214,174,9,11,38,0,1
BT.,BT.4.1,"503 | HDH. Atoll, Male' - 4",617,433,3,436,235,201,40,0,155,189,7,16,23,3,1
BT.,BT.6.1,"504 | HDH. Atoll, Male' - 5",704,557,8,565,320,245,23,0,179,307,4,16,17,11,1
C01,C01.01.1,50 | Sh. Kanditheemu - 1,782,624,5,629,283,346,6,1,278,307,15,1,16,0,1
C01,C01.02.1,51 | Sh. Noomara - 1,298,209,10,219,112,107,5,1,159,32,8,1,3,0,1
C01,C01.03.1,52 | Sh. Goidhoo - 1,385,321,9,330,146,184,2,0,199,107,11,0,2,0,1
C01,C01.04.1,53 | Sh. Feydhoo - 1,667,450,24,474,208,266,7,2,222,180,5,2,32,0,1
C01,C01.06.1,55 | Sh. Bilehfahi - 1,373,311,7,318,153,165,1,0,94,178,0,0,38,0,1
C02,C02.05.1,54 | Sh. Feevah - 1,479,347,35,382,180,202,22,3,121,183,10,2,2,4,1
C02,C02.08.1,58 | Sh. Narudhoo - 1,372,319,17,336,153,183,11,1,166,126,3,0,12,0,1
C02,C02.14.1,66 | Sh. Milandhoo - 1,607,529,16,545,253,292,6,6,263,244,4,1,5,0,1
C02,C02.14.2,67 | Sh. Milandhoo - 2,818,724,11,735,328,407,9,0,412,293,3,0,7,0,1
C03,C03.07.1,56 | Sh. Foakaidhoo - 1,498,432,7,439,201,238,1,2,216,197,2,0,7,7,1
C03,C03.07.2,57 | Sh. Foakaidhoo - 2,476,423,2,425,185,240,10,0,204,185,2,1,6,15,1
C03,C03.09.1,59 | Sh. Maroshi - 1,386,322,4,326,160,166,9,0,162,117,11,1,22,0,1
C03,C03.11.1,61 | Sh. Komandoo - 1,404,362,9,371,181,190,1,2,182,157,6,1,4,9,1
C03,C03.11.2,62 | Sh. Komandoo - 2,342,296,13,309,149,160,2,2,161,101,12,1,8,9,1
C04,C04.10.1,60 | Sh. Lhaimagu - 1,421,309,19,328,149,179,14,0,180,95,4,2,13,1,1
C04,C04.12.1,63 | Sh. Maaungoodhoo - 1,643,525,25,550,273,277,9,0,262,235,1,0,18,0,1
C04,C04.13.1,64 | Sh. Funadhoo - 1,763,585,7,592,258,334,19,0,194,345,11,4,12,0,1
C04,C04.13.2,65 | Sh. Funadhoo - 2,774,588,9,597,261,336,30,2,169,357,12,1,16,1,1
CT.,CT.1.1,"505 | SH. Atoll, Male' - 1",672,524,7,531,300,231,14,1,181,295,4,12,17,0,1
CT.,CT.2.1,"506 | SH. Atoll, Male' - 2",591,464,3,467,280,187,42,0,153,249,7,3,9,1,1
CT.,CT.3.1,"507 | SH. Atoll, Male' - 3",849,686,20,706,406,300,28,0,283,335,6,3,24,7,1
CT.,CT.4.1,"508 | SH. Atoll, Male' - 4",473,393,2,395,229,166,24,3,138,194,11,8,11,4,1
D01,D01.01.1,68 | N. Henbadhoo - 1,465,370,15,385,177,208,13,1,185,135,33,0,2,1,1
D01,D01.02.1,69 | N. Kendhikulhudhoo - 1,565,441,8,449,213,236,12,0,208,213,1,1,4,2,1
D01,D01.02.2,70 | N. Kendhikulhdhoo - 2,563,486,6,492,236,256,20,1,234,202,4,1,24,0,1
D01,D01.03.1,71 | N. Maalhendhoo - 1,544,473,5,478,239,239,15,0,229,218,5,0,5,1,1
D01,D01.04.1,72 | N. Kudafari - 1,424,344,10,354,203,151,16,0,198,90,1,1,35,3,1
D02,D02.05.1,73 | N. Landhoo - 1,550,461,17,478,216,262,8,0,217,193,14,1,28,0,1
D02,D02.06.1,74 | N. Maafaru - 1,655,510,6,516,244,272,10,0,193,218,7,1,81,0,1
D02,D02.10.1,78 | N. Manadhoo - 1,394,302,10,312,171,141,4,1,141,127,3,0,25,1,1
D02,D02.10.2,79 | N. Manadhoo - 2,675,471,59,530,248,282,13,0,208,213,4,3,29,1,1
D03,D03.07.1,75 | N. Lhohi - 1,509,387,28,415,208,207,1,0,145,179,1,0,61,0,1
D03,D03.12.1,82 | N. Fodhdhoo - 1,233,199,1,200,97,103,1,0,110,81,1,4,2,0,1
D03,D03.13.1,83 | N. Velidhoo - 1,424,342,5,347,176,171,1,0,148,154,7,0,32,0,1
D03,D03.13.2,84 | N. Velidhoo - 2,474,377,14,391,206,185,1,1,159,183,5,1,26,1,1
D03,D03.13.3,85 | N. Velidhoo - 3,438,359,9,368,181,187,2,0,146,175,6,1,28,1,1
D04,D04.08.1,76 |N. Miladhoo - 1,727,636,8,644,311,333,16,2,347,243,0,1,25,2,1
D04,D04.09.1,77 | N. Magoodhoo - 1,239,210,0,210,110,100,1,0,119,87,0,0,3,0,1
D04,D04.11.1,80 | N. Holhudhoo - 1,575,459,11,470,229,241,5,0,198,238,9,1,8,0,1
D04,D04.11.2,81 | N. Holhudhoo - 2,556,416,20,436,210,226,8,0,134,248,11,3,12,0,1
DT.,DT.1.1,"509 | N. Atoll, Male' - 1",394,296,5,301,149,152,16,0,119,135,5,5,16,0,1
DT.,DT.1.2,"611 | N. Atoll, Male, - 4",644,542,3,545,263,282,26,0,206,260,6,8,33,3,1
DT.,DT.2.1,"510 | N. Atoll, Male' - 2",625,482,11,493,226,267,18,0,172,235,14,9,31,3,1
DT.,DT.3.1,"511 | N. Atoll, Male' - 3",702,595,5,600,285,315,13,0,233,269,11,10,56,3,1
E01,E01.01.1,86 | R. Alifushi - 1,446,357,13,370,176,194,8,0,176,155,2,0,16,0,1
E01,E01.01.2,87 | R. Alifushi - 2,277,193,23,216,104,112,2,0,93,89,4,1,4,0,1
E01,E01.01.3,88 | R. Alifushi - 3,481,372,8,380,170,210,6,1,134,211,5,4,11,0,1
E01,E01.02.1,89 | R. Vaadhoo - 1,335,281,5,286,142,144,2,0,150,119,6,1,3,0,1
E01,E01.03.1,90 | R. Rasgetheemu - 1,408,311,9,320,155,165,5,0,158,115,4,0,23,6,1
E01,E01.04.1,91 | R. Angolhitheemu - 1,275,217,13,230,113,117,20,0,82,80,10,0,16,9,1
E02,E02.05.1,92 | R. Hulhudhuffaaru - 1,469,345,7,352,179,173,12,2,130,159,10,2,30,0,1
E02,E02.05.2,93 | R. Hulhudhuffaaru - 2,404,263,22,285,130,155,9,0,101,121,7,0,23,2,1
E02,E02.06.1,94 | R. Ungoofaaru - 1,576,463,18,481,251,230,17,0,130,288,9,0,18,1,1
E02,E02.06.2,95 | R. Ungoofaaru - 2,529,384,31,415,218,197,9,1,143,165,25,0,41,0,1
E02,E02.08.1,100 | R. Maakurath - 1,687,493,11,504,260,244,8,1,191,258,6,3,26,0,1
E03,E03.07.1,96 | R. Dhuvaafaru - 1,595,415,36,451,215,236,4,0,139,243,0,2,26,1,1
E03,E03.07.2,97 | R. Dhuvaafaru - 2,608,433,23,456,241,215,3,1,187,209,2,0,28,3,1
E03,E03.07.3,98 | R. Dhuvaafaru - 3,630,424,46,470,243,227,7,0,171,218,2,0,23,3,1
E03,E03.07.4,99 | R. Dhuvaafaru - 4,660,472,14,486,260,226,14,1,179,252,4,0,17,5,1
E04,E04.09.1,101 | R. Rasmaadhoo - 1,427,363,16,379,185,194,7,0,150,168,3,0,4,31,1
E04,E04.10.1,102 | R. Innamaadhoo - 1,462,382,27,409,218,191,4,0,162,213,0,1,2,0,1
E04,E04.12.1,105 | R. Inguraidhoo - 1,413,272,37,309,138,171,15,1,102,139,1,1,10,3,1
E04,E04.12.2,106 | R. Inguraidhoo - 2,668,503,17,520,247,273,18,1,165,306,1,0,10,2,1
E04,E04.14.1,109 | R. Fainu - 1,273,251,0,251,122,129,5,0,86,132,1,0,27,0,1
E04,E04.15.1,110 | R. Kinolhas - 1,318,272,15,287,136,151,3,0,220,46,1,0,2,0,1
E05,E05.11.1,103 | R. Maduvvari - 1,728,519,13,532,286,246,14,2,205,260,0,1,26,11,1
E05,E05.11.2,104 | R. Maduvvari  - 2,641,422,43,465,245,220,4,2,199,192,0,0,21,4,1
E05,E05.13.1,107 | R. Meedhoo - 1,757,599,6,605,314,291,14,2,185,385,4,0,9,0,1
E05,E05.13.2,108 | R. Meedhoo - 2,588,475,3,478,255,223,13,0,119,322,4,1,15,1,1
ET.,ET.1.1,"512 | R. Atoll, Male' - 1",665,558,2,560,288,272,18,1,243,270,8,6,10,2,1
ET.,ET.1.2,"513 | R. Atoll, Male' - 2",427,345,2,347,165,182,21,0,114,165,21,5,18,1,1
ET.,ET.2.2,"514 | R. Atoll, Male' - 3",552,385,7,392,213,179,27,0,105,226,7,1,19,0,1
ET.,ET.3.1,"515 | R. Atoll, Male' - 4",682,522,8,530,255,275,15,0,149,314,2,6,33,3,1
ET.,ET.4.1,"516 | R. Atoll, Male' - 5",731,616,5,621,380,241,35,0,252,279,8,6,30,6,1
ET.,ET.5.1,"517 | R. Atoll, Male' - 6",520,402,9,411,205,206,14,0,165,195,2,6,18,2,1
F01,F01.09.1,121 | B. Thulhaadhoo - 1,352,265,3,268,135,133,3,0,52,156,21,3,30,0,1
F01,F01.09.2,122 | B. Thulhaadhoo - 2,435,348,4,352,183,169,3,1,133,68,42,1,100,0,1
F01,F01.09.3,123 | B. Thulhaadhoo - 3,589,461,9,470,241,229,4,1,155,168,34,3,96,0,1
F01,F01.11.1,125 | B. Fulhadhoo - 1,205,182,2,184,107,77,1,0,99,68,2,0,12,0,1
F01,F01.12.1,126 | B. Fehendhoo - 1,168,143,5,148,85,63,1,0,71,51,2,1,17,0,1
F01,F01.13.1,127 | B. Goidhoo - 1,448,349,2,351,180,171,8,0,175,115,7,0,37,7,1
F02,F02.07.1,117 | B. Maalhos - 1,408,336,5,341,163,178,4,0,123,130,3,0,65,11,1
F02,F02.08.1,118 | B. Eydhafushi - 1,556,450,12,462,223,239,12,0,117,281,9,5,26,0,1
F02,F02.08.2,119 | B. eydhafushi -2,604,476,11,487,239,248,6,0,169,271,4,4,22,0,1
F02,F02.08.3,120 | B. Eydhafushi - 3,651,551,14,565,285,280,5,3,187,322,3,1,29,1,1
F02,F02.10.1,124 | B. Hithaadhoo - 1,562,431,8,439,210,229,20,2,177,165,14,0,53,0,1
F03,F03.01.1,111 | B. Kudarikilu - 1,337,294,3,297,149,148,3,0,91,136,5,0,59,0,1
F03,F03.02.1,112 | B. Kamadhoo - 1,305,242,20,262,145,117,2,0,132,97,1,2,7,1,1
F03,F03.03.1,113 | B. Kendhoo - 1,690,548,15,563,305,258,13,1,316,193,13,3,4,5,1
F03,F03.04.1,114 | B. Kihaadhoo - 1,353,295,5,300,159,141,14,0,139,94,10,0,34,4,1
F03,F03.05.1,115 | B. Dhonfanu - 1,335,258,10,268,137,131,6,0,162,67,12,1,9,1,1
F03,F03.06.1,116 | B. Dharavandhoo - 1,599,483,10,493,262,231,7,1,213,179,25,6,40,12,1
FT.,FT.1.1,"518 | B. Atoll, Male' - 1",601,493,4,497,273,224,27,2,174,239,10,9,29,3,1
FT.,FT.2.1,"519 | B. Atoll, Male' - 2",602,510,4,514,261,253,6,1,143,305,5,9,37,4,1
FT.,FT.3.1,"520 | B. Atoll, Male' - 3",711,599,7,606,283,323,33,1,215,275,21,12,38,4,1
FT.,FT.4.1,"615 | B. Atoll, Male' - 4",717,601,7,608,305,303,16,3,193,245,32,20,89,3,1
G01,G01.01.1,128 | Lh. Hinnavaru - 1,408,316,3,319,153,166,2,0,181,131,1,0,1,0,1
G01,G01.01.2,129 | Lh. Hinnavaru - 2,469,388,5,393,210,183,2,0,206,171,3,0,6,0,1
G01,G01.01.3,130 | Lh. Hinnavaru - 3,384,286,9,295,153,142,2,0,198,76,5,0,5,0,1
G01,G01.01.4,131 | Lh. Hinnavaru - 4,473,370,7,377,200,177,5,0,233,129,0,0,3,0,1
G01,G01.01.5,132 | Lh. Hinnavaru - 5,462,350,7,357,178,179,3,0,212,130,2,1,0,2,1
G02,G02.02.1,133 | Lh. Naifaru - 1,638,489,3,492,258,234,11,0,133,279,4,4,52,6,1
G02,G02.02.2,134 | Lh. Naifaru - 2,649,456,15,471,248,223,16,0,128,257,10,5,39,1,1
G02,G02.02.3,135 | Lh. Naifaru - 3,782,539,12,551,274,277,18,3,159,284,6,7,59,3,1
G02,G02.02.4,136 | Lh. Naifaru - 4,573,457,5,462,248,214,21,1,126,275,4,2,27,1,1
G02,G02.02.5,137 | Lh. Naifaru - 5,659,453,8,461,223,238,12,4,129,259,3,3,37,6,1
G03,G03.03.1,138 | Lh. Kurendhoo - 1,413,325,9,334,153,181,2,0,167,142,1,0,13,0,1
G03,G03.03.2,139 | Lh. Kurendhoo - 2,494,405,4,409,189,220,5,0,255,123,2,1,18,1,1
G03,G03.04.1,140 | Lh. Olhuvelifushi - 1,505,443,5,448,233,215,8,0,256,176,0,0,2,1,1
GT.,GT.1.1,"521 | LH. Atoll, Male' - 1",514,445,4,449,220,229,8,0,263,150,7,3,8,6,1
GT.,GT.1.2,"522 | LH. Atoll, Male' - 2",541,442,5,447,209,238,6,1,244,158,12,2,10,9,1
GT.,GT.2.1,"523 | LH. Atoll, Male' - 3",638,495,3,498,234,264,27,3,186,208,8,19,42,2,1
GT.,GT.3.1,"524 | LH. Atoll, Male' - 4",493,420,1,421,213,208,7,0,210,167,2,10,19,5,1
H01,H01.01.1,141 | K. Kaashidhoo - 1,749,586,9,595,273,322,11,1,279,272,2,6,12,3,1
H01,H01.01.2,142 | K. Kaashidhoo - 2,632,471,12,483,233,250,17,0,171,249,3,4,11,16,1
H01,H01.02.1,143 | K. Gaafaru - 1,429,397,3,400,195,205,6,1,173,205,1,0,11,0,1
H01,H01.02.2,144 | K. Gaafaru - 2,388,335,12,347,186,161,4,0,144,176,2,0,9,0,1
H02,H02.03.1,145 | K. Dhiffushi - 1,758,598,12,610,293,317,15,0,214,305,5,1,55,3,1
H02,H02.03.2,146 | K. Dhiffushi - 2,217,177,3,180,156,24,7,0,77,71,3,0,16,3,1
H02,H02.04.1,147 | K.Thulusdhoo - 1,390,329,4,333,165,168,3,1,88,223,0,3,9,2,1
H02,H02.04.2,148 | K.Thulusdhoo - 2,429,320,3,323,162,161,11,0,86,200,3,4,16,0,1
H02,H02.05.1,149 | K.Hura - 1,707,566,6,572,277,295,31,2,148,345,3,4,26,7,1
H02,H02.05.2,150 |  K.Hura - 2,194,161,0,161,134,27,7,0,66,69,1,2,15,1,1
H02,H02.06.1,151 | K. Hinmafushi - 1,707,605,4,609,322,287,17,0,235,346,2,0,4,1,1
H02,H02.06.2,152 | K. Hinmafushi - 2,120,93,9,102,73,29,8,0,25,56,1,2,1,0,1
H03,H03.07.1,153 | K. Gulhi - 1,609,538,3,541,289,252,12,0,236,267,4,3,12,4,1
H03,H03.08.1,154 | K. Maafushi - 1,537,396,24,420,200,220,8,0,190,171,3,1,23,0,1
H03,H03.08.2,155 | K. Maafushi - 2,537,430,5,435,216,219,11,1,185,218,0,2,12,1,1
H03,H03.08.3,156 | K. Maafushi-3,123,108,1,109,60,49,2,0,42,56,4,0,4,0,1
H03,H03.09.1,157 | K. Guraidhoo - 1,576,462,3,465,268,197,6,0,178,244,5,0,25,4,1
H03,H03.09.2,158 | K. Guraidhoo - 2,692,552,8,560,299,261,9,1,230,296,2,1,12,1,1
HT.,HT.1.1,"525 | K. Atoll, Male' - 1",748,603,5,608,317,291,24,1,190,335,3,15,32,3,1
HT.,HT.2.1,"526 | K. Atoll, Male' - 2",436,337,4,341,152,189,13,0,121,162,2,0,35,4,1
I01,I01.09.1,253 | Adh. Fenfushi - 1,589,407,37,444,235,209,11,0,149,153,85,0,9,0,0
I01,I01.10.1,254 | Adh. Maamigili - 1,479,375,7,382,198,184,8,0,40,63,207,0,56,1,0
I01,I01.10.2,255 | Adh. Maamigili - 2,541,417,12,429,232,197,8,1,34,89,265,0,20,0,0
I01,I01.10.3,256 | Adh. Maamigili - 3,740,538,12,550,274,276,15,1,69,123,309,0,21,0,0
I02,I02.01.1,243 | Adh. Hangnaameedhoo - 1,389,318,1,319,182,137,22,3,135,119,24,1,10,4,0
I02,I02.03.1,245 | Adh. Kunburudhoo - 1,401,329,0,329,180,149,12,0,187,104,24,1,0,1,0
I02,I02.04.1,246 | Adh. Mahibadhoo - 1,663,507,12,519,280,239,35,1,156,272,16,3,24,0,0
I02,I02.04.2,247 | Adh. Mahibadhoo - 2,810,653,5,658,344,314,31,1,221,350,16,3,31,0,0
I03,I03.02.1,244 | Adh. Omadhoo - 1,656,473,13,486,234,252,40,10,225,159,24,4,9,2,0
I03,I03.05.1,248 | Adh. Mandhoo - 1,296,218,5,223,134,89,12,2,78,110,12,0,3,1,0
I03,I03.06.1,249 | Adh. Dhangethi - 1,538,388,36,424,216,208,37,1,128,149,55,1,12,5,0
I03,I03.06.2,250 | Adh. Dhangethi - 2,189,168,0,168,151,17,6,0,75,69,5,0,13,0,0
I03,I03.07.1,251 | Adh. Dhigurah - 1,433,365,19,384,202,182,4,1,179,100,81,0,0,0,0
I03,I03.08.1,252 | Adh. Dhidhdhoo - 1,120,92,2,94,41,53,6,0,43,19,18,0,0,6,0
IT.,IT.1.1,"528 | ADH. Atoll, Male' - 1",751,593,6,599,292,307,31,0,134,280,102,11,34,1,1
IT.,IT.2.1,"529 | ADH. Atoll, Male' - 2",397,299,4,303,165,138,26,0,89,147,19,4,7,7,1
J01,J01.01.1,257 | V. Fulidhoo - 1,278,227,2,229,132,97,5,0,102,102,6,0,12,0,1
J01,J01.02.1,258 | V. Thinadhoo - 1,92,67,1,68,39,29,0,0,32,20,1,0,14,0,1
J01,J01.03.1,259 | V. Felidhoo - 1,363,299,6,305,166,139,3,0,103,184,1,0,6,2,1
J02,J02.04.1,260 | V. Keyodhoo - 1,477,392,9,401,203,198,0,1,196,161,6,0,27,1,1
J02,J02.05.1,261 | V. Rakeedhoo - 1,133,104,1,105,62,43,0,0,51,47,3,1,2,0,1
JT.,JT.1.1,"530 | V. Atoll, Male' - 1",484,396,7,403,192,211,12,0,189,171,8,1,13,2,1
K01,K01.01.1,262 | M. Raiymandhoo - 1,118,101,1,102,52,50,0,0,56,41,2,0,2,0,1
K01,K01.02.1,263 | M. Veyvah - 1,177,162,0,162,80,82,2,0,83,74,2,0,0,1,1
K01,K01.04.1,266 | M. Muli - 1,523,435,6,441,222,219,20,0,175,208,2,7,6,17,1
K01,K01.07.1,269 | M. Dhiggaru - 1,732,637,4,641,292,349,7,2,348,249,1,6,18,6,1
K01,K01.08.1,270 | M. Maduvvari - 1,243,214,7,221,119,102,1,0,88,100,5,1,18,1,1
K02,K02.03.1,264 | M. Mulah - 1,462,362,12,374,175,199,2,0,125,211,10,0,9,5,1
K02,K02.03.2,265 | M. Mulah - 2,474,396,6,402,203,199,5,0,118,222,18,0,17,16,1
K02,K02.05.1,267 | M. Naalaafushi - 1,328,300,0,300,162,138,4,0,133,158,1,0,4,0,1
K02,K02.06.1,268 | M. Kolhufushi - 1,627,510,8,518,239,279,7,0,254,210,3,0,34,2,1
KT.,KT.1.1,"531 | M. Atoll, Male' - 1",641,545,4,549,277,272,40,1,194,257,6,9,34,4,1
KT.,KT.2.1,"532 | M. Atoll, Male' - 2",685,566,2,568,286,282,27,0,219,286,9,3,18,4,1
L01,L01.01.1,271 | F. Feeali - 1,689,559,12,571,278,293,7,1,250,216,67,2,7,9,0
L01,L01.02.1,272 | F. Bilehdhoo - 1,696,544,15,559,287,272,10,1,276,188,5,0,61,3,0
L01,L01.03.1,273 | F. Magoodhoo - 1,457,406,9,415,208,207,2,1,237,155,5,3,1,2,0
L02,L02.04.1,274 | F. Dharanboodhoo - 1,313,284,2,286,150,136,3,2,131,103,9,0,32,4,0
L02,L02.05.1,275 | F. Nilandhoo - 1,489,425,9,434,204,230,12,1,132,247,5,6,4,18,0
L02,L02.05.2,276 | F. Nilandhoo - 2,561,488,2,490,205,285,19,1,126,322,7,1,3,9,0
LT.,LT.1.1,"533 | F. Atoll, Male' - 1",469,361,5,366,178,188,18,1,149,169,6,3,11,4,1
LT.,LT.2.1,"534 | F. Atoll, Male' - 2",426,382,2,384,217,167,24,0,62,261,13,8,12,2,1
M01,M01.01.1,277 | Dh. Meedhoo - 1,394,347,10,357,215,142,6,0,159,163,2,1,13,3,1
M01,M01.01.2,278 | Dh. Meedhoo - 2,330,292,6,298,171,127,5,0,131,151,1,0,4,0,1
M01,M01.02.1,279 | Dh. Bandidhoo - 1,457,375,8,383,212,171,8,0,254,93,15,1,4,0,1
M01,M01.03.1,280 | Dh. Rinbudhoo - 1,227,206,0,206,110,96,4,0,128,68,0,0,5,1,1
M01,M01.04.1,281 | Dh. Hulhudheli - 1,549,488,9,497,241,256,8,0,200,204,61,2,12,1,1
M02,M02.06.1,282 | Dh. Maaenboodhoo - 1,590,480,2,482,253,229,8,1,172,253,6,1,38,1,1
M02,M02.07.1,283 | Dh. Kudahuvadhoo - 1,682,580,10,590,293,297,11,0,135,376,5,2,47,4,1
M02,M02.07.2,284 | Dh. Kudahuvadhoo - 2,554,486,9,495,258,237,8,1,154,268,10,0,40,5,1
M02,M02.07.3,285 | Dh. Kudahuvadhoo - 3,648,542,22,564,253,311,6,0,291,220,8,0,15,2,1
MT.,MT.1.1,"535 | Dh. Atoll, Male' - 1",623,523,5,528,234,294,21,1,189,260,9,15,25,3,1
MT.,MT.2.1,"536 | Dh. Atoll, Male' - 2",545,468,3,471,247,224,12,0,144,272,5,6,26,3,1
N01,N01.01.1,286 | Th. Buruni - 1,240,185,11,196,87,109,1,0,80,95,2,0,5,2,1
N01,N01.02.1,287 | Th. Vilufushi - 1,413,279,33,312,151,161,7,2,111,128,14,2,15,0,1
N01,N01.02.2,288 | Th. Vilufushi - 2,355,237,23,260,124,136,0,0,93,117,4,0,22,1,1
N01,N01.03.1,289 | Th. Madifushi - 1,617,461,22,483,219,264,3,1,165,250,14,3,21,4,1
N02,N02.10.1,297 | Th. Thimarafushi - 1,409,245,6,251,139,112,0,0,108,79,2,0,31,25,1
N02,N02.10.2,298 | Th. Thimarafushi - 2,226,121,3,124,68,56,1,0,39,41,1,0,8,31,1
N02,N02.10.3,299 | Th. Thimarafushi - 3,296,188,2,190,101,89,0,0,73,68,1,1,16,29,1
N02,N02.11.1,300 | Th. Veymandoo - 1,757,659,5,664,324,340,13,3,201,363,22,5,32,20,1
N03,N03.06.1,293 | Th. Kandoodhoo - 1,303,271,3,274,131,143,8,0,117,104,1,0,22,19,1
N03,N03.07.1,294 | Th. Vandhoo - 1,256,224,7,231,127,104,2,1,106,110,0,0,3,2,1
N03,N03.08.1,295 | Th. Hirilandhoo - 1,732,649,3,652,338,314,42,0,327,237,3,0,15,25,1
N03,N03.12.1,301 | Th. Kinbidhoo - 1,495,391,13,404,190,214,7,0,131,147,7,1,95,3,1
N03,N03.13.1,302 | Th. Omadhoo - 1,324,272,5,277,148,129,5,0,125,107,7,0,17,11,1
N04,N04.04.1,290 | Th. Dhiyamigili - 1,423,357,8,365,174,191,2,0,184,158,1,0,12,0,1
N04,N04.05.1,291 | Th. Guraidhoo - 1,521,425,5,430,194,236,3,0,107,280,0,2,32,1,1
N04,N04.05.2,292 | Th. Guraidhoo - 2,490,420,3,423,215,208,3,0,106,275,5,0,28,3,1
N04,N04.09.1,296 | Th. Gaadhiffushi - 1,243,216,4,220,109,111,0,0,95,96,1,0,22,2,1
NT.,NT.1.1,"537 |  TH. Atoll, Male' - 1",440,362,3,365,178,187,12,1,139,176,6,5,21,2,1
NT.,NT.1.2,"613 | Th. Atoll, Male' - 5",502,402,6,408,209,199,13,0,169,173,6,7,33,1,1
NT.,NT.2.1,"538 | TH. Atoll, Male' - 2",829,608,18,626,327,299,15,1,236,253,14,5,56,28,1
NT.,NT.3.1,"539 | TH. Atoll, Male' - 3",824,648,23,671,341,330,31,0,252,285,11,11,46,12,1
NT.,NT.4.1,"540 | TH. Atoll, Male' - 4",745,628,5,633,328,305,11,0,214,332,8,9,52,2,1
O01,O01.01.1,303 | L. Isdhoo - 1,680,567,14,581,249,332,6,1,284,223,4,3,32,14,1
O01,O01.02.1,304 | L. Dhanbidhoo - 1,532,428,9,437,213,224,3,1,203,201,9,1,5,5,1
O01,O01.03.1,305 | L. Maabaidhoo - 1,406,341,1,342,163,179,3,0,153,174,6,0,2,3,1
O01,O01.12.1,319 | L. Kalaidhoo - 1,452,371,9,380,195,185,4,1,143,202,0,1,20,0,1
O02,O02.04.1,306 | L. Mundoo - 1,145,116,0,116,60,56,5,0,68,38,3,0,2,0,1
O02,O02.05.1,307 | L. Gan - 1,742,627,7,634,302,332,16,0,239,273,11,4,82,2,1
O02,O02.05.2,308 | L. Gan - 2,653,580,8,588,322,266,9,0,301,255,5,3,7,0,1
O02,O02.05.3,309 | L. Gan - 3,688,560,2,562,284,278,13,2,238,248,24,4,28,3,1
O02,O02.05.4,310 | L. Gan - 4,817,643,10,653,334,319,12,1,239,346,20,1,22,2,1
O03,O03.07.1,313 | L. Fonadhoo - 1,540,417,31,448,211,237,11,0,122,261,4,0,11,8,1
O03,O03.07.2,314 | L. Fonadhoo - 2,683,602,7,609,269,340,8,0,103,465,8,4,11,3,1
O03,O03.07.3,315 | L. Fonadhoo - 3,528,376,40,416,216,200,15,0,112,201,10,1,20,17,1
O03,O03.09.1,316 | L. Maamendhoo - 1,664,537,17,554,256,298,4,0,207,307,8,1,9,1,1
O04,O04.06.1,311 | L. Maavah - 1,450,369,0,369,163,206,14,0,111,224,4,1,8,7,1
O04,O04.06.2,312 | L. Maavah - 2,596,473,11,484,223,261,9,0,203,233,6,0,20,2,1
O04,O04.10.1,317 | L. Hithadhoo - 1,768,635,5,640,325,315,3,0,246,292,14,0,80,0,1
O04,O04.11.1,318 | L. Kunahandhoo - 1,504,367,38,405,192,213,6,1,161,174,4,1,13,7,1
OT.,OT.1.1,"541 | L. Atoll, Male' - 1",842,689,5,694,371,323,27,2,237,382,6,5,27,3,1
OT.,OT.2.1,"542 | L. Atoll, Male' - 2",692,561,1,562,281,281,22,0,197,291,7,15,27,2,1
OT.,OT.3.1,"543 | L. Atoll, Male' - 3",483,374,4,378,210,168,14,0,101,215,4,12,22,6,1
OT.,OT.3.2,"614 | L. Atoll, Male' - 4",492,391,3,394,197,197,17,0,154,185,3,4,23,5,1
P01,P01.01.1,320 | Ga. Kolamaafushi - 1,347,305,2,307,159,148,0,0,101,167,0,0,37,0,1
P01,P01.01.2,321 | Ga. Kolamaafushi - 2,235,218,7,225,122,103,2,0,89,92,0,0,35,0,1
P01,P01.02.1,322 | Ga. Villingili - 1,585,508,25,533,281,252,5,0,181,266,1,1,47,7,1
P01,P01.02.2,323 | Ga. Villingili - 2,685,581,12,593,289,304,1,0,187,296,3,0,82,12,1
P01,P01.02.3,324 | Ga. Villingili - 3,682,584,15,599,341,258,11,0,214,309,1,2,43,4,1
P02,P02.03.1,325 | Ga. Maamendhoo - 1,839,688,9,697,365,332,5,2,266,280,19,1,114,1,1
P02,P02.04.1,326 | Ga. Nilandhoo - 1,385,320,10,330,176,154,0,1,136,169,1,0,12,1,1
P02,P02.05.1,327 | Ga. Dhaandhoo - 1,340,279,12,291,160,131,0,0,150,108,4,0,14,3,1
P02,P02.05.2,328 | Ga. Dhaandhoo - 2,436,335,31,366,186,180,0,1,164,143,3,1,23,0,1
P03,P03.06.1,329 | Ga. Dhevvadhoo - 1,381,344,8,352,203,149,1,0,127,174,0,0,42,0,1
P03,P03.07.1,330 | Ga. Kondey - 1,250,209,1,210,105,105,1,0,88,106,6,0,8,0,1
P03,P03.08.1,331 | Ga. Gemanafushi - 1,511,424,5,429,208,221,5,0,166,189,36,0,25,3,1
P03,P03.08.2,332 | Ga. Gemanafushi - 2,367,291,3,294,147,147,11,1,95,152,9,0,23,0,1
P03,P03.09.1,333 | Ga. Kanduhulhudhoo - 1,397,358,3,361,181,180,5,0,126,167,6,1,52,1,1
PT.,PT.1.1,"544 |GA. Atoll, Male' - 1",457,413,4,417,207,210,5,0,148,195,2,9,54,0,1
PT.,PT.1.2,"545 | GA. Atoll, Male' - 2",725,593,20,613,325,288,13,0,205,316,13,11,33,2,0
PT.,PT.2.1,"546 | GA. Atoll, Male' - 3",529,432,22,454,213,241,8,0,204,184,5,8,21,2,0
PT.,PT.2.2,"547 | GA. Atoll, Male' - 4",415,340,6,346,160,186,6,0,104,199,9,7,13,2,0
PT.,PT.3.1,"548 | GA. Atoll, Male' - 5",609,543,5,548,262,286,9,0,215,252,6,6,53,2,0
PT.,PT.3.2,"549 | GA. Atoll, Male' - 6",534,429,9,438,225,213,19,1,112,245,25,4,22,1,0
Q01,Q01.01.1,334 | Gdh. Thinadhoo - 1,270,211,21,232,142,90,6,0,69,103,3,0,29,1,1
Q01,Q01.01.2,335 | Gdh. Thinadhoo - 2,604,443,22,465,228,237,4,0,164,204,14,2,55,0,1
Q01,Q01.01.3,336 | Gdh. Thinadhoo - 3,482,346,7,353,169,184,0,0,128,159,6,2,51,0,1
Q01,Q01.01.4,337 | Gdh. Thinadhoo - 4,632,420,9,429,201,228,3,0,155,207,9,3,40,3,1
Q02,Q02.01.1,338 | Gdh. Thinadhoo - 5,626,405,27,432,219,213,2,0,128,216,12,2,43,2,1
Q02,Q02.01.2,339 | Gdh. Thinadhoo - 6,483,344,17,361,188,173,5,0,113,169,8,0,49,0,1
Q02,Q02.01.3,340 | Gdh. Thinadhoo - 7,540,342,25,367,183,184,4,0,133,171,2,1,30,1,1
Q03,Q03.02.1,341 | Gdh. Madaveli - 1,424,328,2,330,172,158,3,1,79,218,1,0,21,5,1
Q03,Q03.02.2,342 | Gdh. Madaveli - 2,534,397,17,414,203,211,2,0,100,230,21,1,30,13,1
Q03,Q03.03.1,343 | Gdh. Hoandedhdhoo - 1,618,481,19,500,246,254,1,1,224,164,8,0,75,8,1
Q03,Q03.04.1,344 | Gdh. Nadellaa - 1,635,453,24,477,251,226,10,0,232,198,5,0,8,0,1
Q04,Q04.06.1,348 | Gdh. Rathafandhoo - 1,445,301,8,309,158,151,3,0,154,124,0,0,20,0,1
Q04,Q04.08.1,350 | Gdh. Fiyoaree - 1,542,402,10,412,204,208,6,0,164,192,1,0,28,11,1
Q04,Q04.09.1,351 | Gdh. Faresmaathodaa - 1,424,334,18,352,194,158,3,0,96,216,2,2,14,1,1
Q04,Q04.09.2,352 | Gdh. Faresmaathodaa - 2,432,343,12,355,186,169,2,0,83,175,1,1,80,1,1
Q05,Q05.05.1,345 | Gdh. Gadhdhoo - 1,427,323,11,334,179,155,3,0,109,169,6,3,32,1,1
Q05,Q05.05.2,346 | Gdh. Gadhdhoo - 2,340,245,2,247,123,124,3,1,97,93,0,0,47,4,1
Q05,Q05.05.3,347 | Gdh. Gadhdhoo - 3,387,311,4,315,162,153,3,0,112,141,0,1,49,5,1
Q05,Q05.07.1,349 | Gdh. Vaadhoo - 1,636,495,7,502,267,235,2,1,338,126,6,2,17,3,1
QT.,QT.1.1,"550| GDH. Atoll, Male' - 1",830,667,9,676,345,331,15,0,248,307,12,24,60,1,0
QT.,QT.2.1,"551 | GDH. Atoll, Male' - 2",630,513,3,516,232,284,17,1,189,225,6,17,55,3,0
QT.,QT.3.1,"552 | GDH. Atoll, Male' - 3",563,417,8,425,211,214,2,0,134,240,7,7,25,2,0
QT.,QT.4.1,"553 | GDH. Atoll, Male' - 4",444,367,6,373,185,188,3,2,115,195,10,5,36,1,0
QT.,QT.4.2,"554 | GDH. Atoll, Male' - 5",743,602,5,607,282,325,15,1,174,346,7,7,51,1,0
QT.,QT.5.1,"555 | GDH. Atoll, Male' - 6",360,301,9,310,155,155,4,0,147,126,2,4,15,3,0
QT.,QT.5.2,"556 | GDH. Atoll, Male' - 7",848,725,8,733,349,384,17,3,255,327,8,16,90,9,0
R01,R01.01.1,353 | Gn. Fuvahmulaku Uthuru Dhaaira - 1,881,746,9,755,355,400,9,1,199,425,65,2,40,5,0
R01,R01.01.2,354 | Fuvahmulaku Uthuru Dhaaira - 2,660,547,13,560,253,307,6,0,214,240,16,2,59,10,0
R01,R01.01.3,355 | Fuvahmualku Uthuru Dhaaira - 3,828,678,5,683,314,369,7,0,284,279,10,3,94,1,0
R02,R02.01.1,356 | Fuvahmulaku Medhu Dhaaira - 1,508,398,8,406,211,195,4,0,139,161,11,4,72,7,0
R02,R02.01.2,357 | Fuvahmulaku Medhu Dhaairaa - 2,591,470,16,486,231,255,5,0,151,248,9,2,51,4,0
R02,R02.01.3,358 | Fuvahmulaku Medhu Dhaairaa - 3,479,375,5,380,177,203,3,0,91,244,3,2,29,3,0
R02,R02.01.4,359 | Fuvahmulaku Medhu Dhaairaa - 4,526,442,13,455,217,238,9,0,210,178,10,1,33,1,0
R03,R03.01.1,360 | Fuvahmulaku Dhekunu Dhaairaa - 1,842,671,46,717,310,407,12,0,218,349,26,2,62,2,0
R03,R03.01.2,361 | Fuvahmulaku Dhekunu Dhaairaa - 2,526,395,12,407,184,223,9,1,117,223,5,1,39,0,0
R03,R03.01.3,362 | Fuvahmulaku Dhekunu Dhaairaa - 3,538,387,37,424,242,182,8,1,115,202,10,5,45,1,0
RT.,RT.1.1,"557 | Fuvahmulah City, Male' - 1",758,645,7,652,315,337,17,1,230,306,16,11,57,7,0
RT.,RT.2.1,"558 | Fuvahmulah City, Male' - 2",571,465,5,470,218,252,10,0,246,142,7,18,41,1,0
RT.,RT.3.1,"559 | Fuvahmulah City, Male' - 3",574,428,8,436,229,207,17,0,157,205,9,6,33,1,0
S01,S01.1.1,"363 | Addu, Hulhudhoo - 1",342,231,2,233,120,113,2,0,61,126,0,0,40,2,1
S01,S01.1.2,"364 | Addu, Hulhudhoo - 2",387,241,12,253,142,111,3,0,67,121,7,0,43,0,1
S01,S01.1.3,"365 | Addu, Hulhudhoo - 3",429,268,16,284,138,146,3,0,95,130,2,2,36,0,1
S02,S02.1.1,"366 | Addu, Feydhoo - 1",548,394,6,400,202,198,0,1,158,176,4,2,46,7,1
S02,S02.1.2,"367 | Addu, Feydhoo - 2",514,363,4,367,184,183,1,0,148,157,8,3,44,2,1
S02,S02.1.3,"368 | Addu, Feydhoo - 3",584,424,18,442,191,251,5,1,147,164,5,5,87,10,1
S02,S02.1.4,"369 | Addu, Feydhoo - 4",601,445,3,448,222,226,4,0,184,182,2,1,65,7,1
S02,S02.1.5,"370 | Addu, Feydhoo - 5",521,368,3,371,178,193,4,0,164,165,0,1,26,8,1
S03,S03.1.1,"371 | Addu, Maradhoo - 1",804,552,14,566,265,301,7,1,288,132,2,4,115,3,1
S03,S03.1.2,"372 | Addu, Maradhoo - 2",545,377,7,384,178,206,5,0,175,94,5,1,94,3,1
S03,S03.1.3,"373 | Addu, Maradhoo - 3",647,442,11,453,228,225,6,0,167,160,2,3,101,3,1
S04,S04.1.1,"374 | Addu, Hithadhoo - 1",852,557,16,573,248,325,15,1,226,189,31,2,88,5,1
S04,S04.1.2,"375 | Addu, Hithadhoo - 2",628,441,4,445,215,230,18,0,196,160,15,3,44,5,1
S04,S04.1.3,"376 | Addu, Hithadhoo - 3",463,285,3,288,124,164,2,0,112,95,13,2,55,6,1
S04,S04.1.4,"377 | Addu, Hithadhoo - 4",512,330,2,332,168,164,12,0,174,69,9,2,60,4,1
S04,S04.1.5,"378 | Addu, hithadhoo - 5",453,290,9,299,146,153,1,0,160,80,7,3,37,2,1
S05,S05.1.1,"379 | Addu, Hithadhoo - 6",534,338,10,348,169,179,1,1,166,99,7,1,56,7,1
S05,S05.1.2,"380 | Addu, Hithadhoo - 7",553,373,8,381,173,208,5,0,148,127,7,6,67,13,1
S05,S05.1.3,"381 | Addu, Hithadhoo - 8",582,391,6,397,185,212,8,1,187,130,14,9,39,3,0
S05,S05.1.4,"382 | Addu, Hithadhoo - 9",620,419,9,428,178,250,6,0,209,126,5,1,68,4,1
S05,S05.1.5,"383 | Addu, Hithadhoo - 10",640,422,4,426,204,222,9,0,183,149,8,8,64,1,1
S06,S06.1.1,"384 | Addu, Hithadhoo - 11",723,458,14,472,269,203,9,1,200,168,8,8,61,3,1
S06,S06.1.2,"385 | Addu, Hithadhoo - 12",601,408,3,411,191,220,6,0,253,96,11,1,39,2,1
S06,S06.1.3,"386 | Addu, Hithadhoo - 13",603,356,16,372,164,208,5,0,181,97,20,4,45,4,1
S06,S06.1.4,"387 | Addu, Hithadhoo - 14",584,388,5,393,178,215,5,0,192,128,7,2,41,13,1
S06,S06.1.5,"388 | Addu, Hithadhoo - 15",893,608,5,613,265,348,16,3,284,195,10,1,93,6,1
S07,S07.1.1,"389 | Addu, Meedhoo - 1",493,353,5,358,162,196,6,1,139,185,0,1,20,1,1
S07,S07.1.2,"390 | Addu, Meedhoo - 2",508,354,11,365,152,213,4,2,141,188,4,3,9,3,1
S07,S07.1.3,"391 | Addu, Meedhoo - 3",478,348,8,356,171,185,6,1,126,184,2,3,25,1,1
S07,S07.2.1,"392 | Addu, Maradhoo Feydhoo - 1",445,338,7,345,174,171,1,1,173,130,2,2,29,0,1
S07,S07.2.2,"393 | Addu, maradhoo Feydhoo - 2",508,356,14,370,151,219,2,1,185,115,1,2,41,9,1
ST.,ST.1.1,"560 | Addu City, Male' - 1",684,579,4,583,285,298,8,0,202,206,11,14,138,0,0
ST.,ST.1.2,"561 | Addu City, Male' - 2",619,516,3,519,223,296,4,1,164,213,5,16,111,2,0
ST.,ST.2.1,"562 |  Addu City, Male' - 3",527,429,3,432,182,250,2,0,174,177,9,9,49,9,1
ST.,ST.2.2,"563 | Addu City, Male' - 4",563,447,7,454,207,247,4,1,198,184,4,16,32,8,1
ST.,ST.3.1,"564 | Addu City, Male' - 5",565,435,4,439,196,243,5,1,138,185,6,20,79,1,1
ST.,ST.4.1,"565 | Addu City, Male' - 6",761,585,10,595,255,340,7,1,244,210,15,26,79,3,1
ST.,ST.5.1,"566 | Addu City, Male' - 7",655,477,2,479,217,262,10,0,182,168,21,20,71,5,1
ST.,ST.6.1,"567 | Addu City, Male' - 8",601,452,2,454,190,264,19,1,208,152,8,12,44,8,1
ST.,ST.7.1,"568 | Addu City, Male' - 9",836,658,11,669,293,376,12,1,260,299,16,24,45,1,1
T01,T01.1.1,159  |  Hulhumale' - 1,753,611,3,614,309,305,32,0,196,305,12,16,43,7,1
T01,T01.1.2,160  | Hulhumale' - 2,751,570,12,582,288,294,28,1,181,288,10,14,44,4,1
T01,T01.1.3,161  | Hulhumale' - 3,761,622,19,641,280,361,30,0,168,336,15,9,61,3,1
T01,T01.1.4,162  | Hulhumale' - 4,782,652,2,654,369,285,21,0,162,342,23,17,84,3,1
T01,T01.1.5,163  | Hulhumale' - 5,765,594,11,605,308,297,22,1,163,315,13,17,59,4,1
T02,T02.1.1,166  | Medhu Henveyru - 1,730,522,8,530,255,275,25,0,202,214,11,14,51,5,1
T02,T02.1.2,167  | Medhu Henveyru - 2,738,540,6,546,277,269,21,1,175,242,12,29,58,2,1
T02,T02.1.3,168  | Medhu Henveyru - 3,809,620,10,630,316,314,30,0,222,272,18,27,45,6,1
T02,T02.1.4,169  | Medhu Henveyru - 4,685,489,8,497,247,250,23,0,175,216,6,22,40,7,1
T03,T03.1.1,170  | Henveyru Dhekunu - 1,764,594,4,598,277,321,22,3,232,266,13,14,44,0,1
T03,T03.1.2,171  | Henveyru Dhekunu - 2,666,515,19,534,263,271,17,2,212,229,6,20,28,1,1
T03,T03.1.3,172  | Henveyru Dhekunu - 3,794,586,9,595,292,303,15,1,229,254,15,17,55,0,1
T03,T03.1.4,173  | Henveyru Dhekunu - 4,646,480,7,487,229,258,13,1,213,192,3,15,39,4,1
T04,T04.1.1,174  | Henveyru Uthuru - 1,675,506,11,517,255,262,23,0,209,216,7,19,29,3,1
T04,T04.1.2,175  | Henveyru Uthuru - 2,652,499,6,505,234,271,22,4,152,232,17,21,49,2,1
T04,T04.1.3,176  | Henveyru Uthuru - 3,635,475,4,479,220,259,28,1,171,183,12,30,49,1,1
T04,T04.1.4,177  | Henveyru Uthuru - 4,520,389,5,394,229,165,7,2,144,175,9,7,40,5,1
T04,T04.1.5,178  | Henveyru Uthuru - 5,544,430,3,433,241,192,16,0,140,216,7,9,37,5,1
T05,T05.1.1,179  | Galolhu Uthuru - 1,752,514,4,518,237,281,13,3,172,224,4,30,56,12,1
T05,T05.1.2,180  | Galolhu Uthuru - 2,728,500,10,510,258,252,16,2,176,148,16,29,104,9,1
T05,T05.1.3,181  | Galolhu Uthuru - 3,614,463,18,481,228,253,19,11,166,184,8,23,49,3,1
T05,T05.1.4,182  | Galolhu Uthuru - 4,822,609,10,619,292,327,19,2,253,211,15,36,69,4,1
T05,T05.1.5,183 | Galolhu Uthuru - 5,699,509,4,513,247,266,16,0,191,201,14,25,52,10,1
T06,T06.1.1,184  | Galolhu Dhekunu - 1,812,620,8,628,329,299,34,0,235,274,25,19,31,2,1
T06,T06.1.2,185  | Galolhu Dhekunu - 2,776,606,8,614,318,296,36,2,238,247,13,17,37,16,1
T06,T06.1.3,186  | Galolhu Dhekunu - 3,687,523,7,530,272,258,16,2,223,225,16,12,27,2,1
T06,T06.1.4,187  | Galolhu Dhekunu - 4,834,624,8,632,323,309,16,1,235,263,18,49,40,2,1
T06,T06.1.5,188  | Galolhu Dhekunu - 5,552,426,9,435,214,221,16,1,171,178,12,17,26,5,1
T07,T07.1.1,189  | Mahchangolhi Uthuru - 1,808,564,8,572,273,299,17,1,210,216,15,25,78,2,1
T07,T07.1.2,190  | Mahchangolhi Uthuru - 2,728,505,4,509,232,277,37,0,192,207,8,21,35,5,1
T07,T07.1.3,191  | Mahchangolhi Uthuru - 3,702,510,7,517,252,265,21,1,186,218,13,24,38,9,1
T07,T07.1.4,192  | Mahchangolhi Uthuru - 4,667,512,5,517,287,230,11,1,153,273,8,8,53,5,1
T08,T08.1.1,193  | Mahchangolhi Dhekunu - 1,699,530,7,537,262,275,33,0,216,224,9,14,30,4,1
T08,T08.1.2,194  | Mahchangolhi Dhekunu - 2,719,556,2,558,281,277,23,0,223,237,9,25,37,2,1
T08,T08.1.3,195  | Mahchangolhi Dhekunu - 3,801,612,11,623,314,309,27,2,224,297,16,17,26,3,1
T08,T08.1.4,196  | Mahchangolhi Dhekunu - 4,799,583,13,596,305,291,17,1,194,286,14,20,47,4,1
T08,T08.1.5,197  | Mahchangolhi Dhekunu - 5,167,135,0,135,76,59,3,0,43,71,3,3,11,1,1
T09,T09.1.1,198  | Maafannu Uthuru - 1,708,504,6,510,265,245,18,2,209,164,24,29,56,2,0
T09,T09.1.2,199  | Maafannu Uthuru - 2,682,491,5,496,229,267,22,1,156,195,10,17,63,27,1
T09,T09.1.3,200 | Maafannu Uthuru - 3,639,430,12,442,214,228,10,0,158,190,5,36,25,6,1
T09,T09.1.4,201 | Maafannu Uthuru - 4,808,591,8,599,291,308,17,0,228,215,12,26,83,10,1
T09,T09.1.5,202 | Maafannu Uthuru - 5,769,551,12,563,293,270,17,2,215,196,15,38,62,6,1
T10,T10.1.1,203 | Maafannu Hulhangu - 1,654,511,6,517,273,244,31,2,184,202,21,20,49,2,1
T10,T10.1.2,204 | Maafannu Hulhangu - 2,730,537,4,541,265,276,24,1,263,156,9,28,50,6,1
T10,T10.1.3,205 | Maafannu Hulhangu - 3,797,568,21,589,280,309,23,1,242,216,6,17,57,6,1
T10,T10.1.4,206 | Maafannu Hulhangu - 4,789,584,7,591,302,289,28,1,227,257,14,13,39,5,1
T10,T10.1.5,207 | Maafannu Hulhangu - 5,651,467,2,469,249,220,34,4,154,207,5,22,37,4,1
T11,T11.1.1,208 | Maafannu Medhu - 1,694,547,6,553,284,269,24,3,236,202,17,17,43,5,1
T11,T11.1.2,209 | Maafannu Medhu - 2,738,534,5,539,266,273,26,1,186,244,16,20,32,9,1
T11,T11.1.3,210 | Maafannu Medhu - 3,711,525,10,535,254,281,29,1,189,223,9,28,43,3,1
T11,T11.1.4,211 | Maafannu Medhu - 4,684,526,6,532,262,270,18,2,181,226,5,20,71,3,1
T11,T11.1.5,212 | Maafannu Medhu - 5,754,589,9,598,276,322,22,1,206,262,23,17,56,2,1
T12,T12.1.1,213 | Maafannu Dhekunu - 1,688,510,7,517,242,275,11,0,181,268,7,16,25,2,1
T12,T12.1.2,214 | Maafannu Dhekunu - 2,679,545,5,550,281,269,17,0,196,279,13,13,21,6,1
T12,T12.1.3,215 | Maafannu Dhekunu - 3,765,579,6,585,294,291,21,3,209,257,13,25,47,4,1
T12,T12.1.4,216 | Maafannu Dhekunu - 4,672,512,4,516,301,215,11,1,165,260,18,10,45,2,1
T13,T13.1.1,217 | Villimale' - 1,654,487,11,498,260,238,10,1,177,222,4,10,46,17,1
T13,T13.1.2,218 | Villimale' - 2,621,470,7,477,243,234,8,0,166,206,10,21,44,15,1
T13,T13.1.3,219 | Villimale' - 3,569,434,10,444,213,231,9,2,167,183,6,14,25,28,1
T13,T13.1.4,220 | Villimale' - 4,516,348,7,355,218,137,5,1,134,160,10,7,27,4,1
T13,T13.1.5,221 | Villimale' - 5,459,330,4,334,151,183,5,0,96,193,3,7,20,6,1
T14,T14.1.1,223 | Henveyru Hulhangu - 1,749,544,7,551,265,286,21,2,190,222,28,29,51,1,1
T14,T14.1.2,224 | Henveyru Hulhangu - 2,770,557,18,575,268,307,23,0,167,256,25,39,44,3,1
T14,T14.1.3,225 | Henveyru Hulhangu - 3,749,508,14,522,233,289,30,0,166,211,12,29,52,8,1
T14,T14.1.4,226 | Henveyru Hulhangu - 4,526,397,7,404,236,168,10,0,120,208,11,12,31,5,1
T15,T15.1.1,227 | Mahchangolhi Medhu - 1,804,578,3,581,272,309,20,9,223,220,8,11,86,1,1
T15,T15.1.2,228 | Mahchangolhi Medhu - 2,844,652,8,660,317,343,29,1,240,286,3,23,66,4,1
T15,T15.1.3,229 | Mahchangolhi Medhu - 3,740,562,17,579,273,306,22,2,195,253,19,16,54,1,1
T15,T15.1.4,230 | Mahchangolhi Medhu - 4,514,345,56,401,249,152,5,1,96,200,17,1,22,3,1
TT.,TT.1.1,231 | Male' Rahyithun - 4,668,501,4,505,241,264,14,0,132,318,7,7,20,3,1
TT.,TT.1.2,232 | Male' Rahyithun - 5,756,603,2,605,253,352,15,0,197,322,22,2,40,5,1
TT.,TT.1.3,164  | Male'  Rahyithun -1,421,398,3,401,168,233,12,1,122,213,15,5,28,2,1
TT.,TT.1.4,165  | Male'  Rahyithun -2,373,289,7,296,124,172,11,1,53,190,8,8,16,2,1
TT.,TT.1.6,610 | Male' - Rahyithun - 6,626,579,12,591,245,346,14,0,124,386,12,10,22,11,1
U01,U01.04.1,238 | Aa. Mathiveri - 1,533,487,2,489,240,249,6,0,193,249,7,1,29,2,1
U01,U01.05.1,239 | Aa. Bodufolhudhoo - 1,466,420,3,423,225,198,13,0,321,70,16,0,0,0,1
U01,U01.06.1,240 | Aa. Feridhoo - 1,470,395,6,401,233,168,11,0,195,177,5,1,5,1,1
U01,U01.07.1,241 | Aa. Maalhos - 1,396,316,22,338,171,167,3,1,164,92,1,0,55,0,1
U01,U01.08.1,242 | Aa. Himandhoo - 1,506,386,7,393,229,164,7,0,189,137,4,0,49,0,1
U02,U02.01.1,233 | Aa. Thoddoo - 1,502,404,3,407,212,195,20,1,115,224,16,0,24,4,1
U02,U02.01.2,234 | Aa. Thoddoo - 2,630,508,5,513,253,260,14,0,201,208,16,7,59,3,1
U02,U02.02.1,235 | Aa. Rasdhoo - 1,670,548,6,554,290,264,3,1,210,224,10,0,94,6,1
U02,U02.02.2,236 | Aa. Rasdhoo - 2,121,99,0,99,71,28,3,1,30,55,0,0,8,2,1
U02,U02.03.1,237 | Aa. Ukulhas - 1,644,594,4,598,320,278,22,1,304,214,11,0,42,0,1
UT.,UT.1.1,"527 | AA. Atoll, Male' - 1",413,336,2,338,151,187,22,0,142,130,13,5,21,3,1
UT.,UT.1.2,"612 | AA. Atoll, Male' - 2",557,457,3,460,209,251,18,0,178,209,8,3,38,3,1
V02,V02.1.1,395 | Hulhule - 1,80,77,0,77,66,11,2,1,17,46,3,4,4,0,0
W01,W01.1.1,401 | India / Trivandrum - 1,417,272,5,277,131,146,7,0,149,90,7,0,17,2,1
W02,W02.1.1,403 | Malaysia / Kuala Lampur - 1,494,416,4,420,151,269,9,0,185,144,12,24,36,6,1
W02,W02.1.2,404 | Malaysia / Kuala Lampur - 2,468,384,2,386,157,229,10,0,151,148,4,20,42,9,1
W02,W02.1.3,616 | Malaysia / Kuala Lumpur - 3,461,367,3,370,208,162,16,1,132,156,7,17,26,12,1
W03,W03.1.1,405 | Srilanka / Colombo - 1,459,397,10,407,171,236,11,0,149,147,12,13,58,7,1
W03,W03.1.2,406 | Srilanka / Colombo - 2,392,345,3,348,111,237,7,0,152,133,9,4,37,3,0
W04,W04.1.1,409 | England / London - 1,465,275,6,281,125,156,4,0,122,77,19,20,30,3,0
W08,W08.1.1,413 | United Arab Emirates / Abu Dhabi - 1,171,95,2,97,56,41,3,0,48,33,4,1,4,2,0
X01,X01.1.1,396 | Hulhumale' Jail,257,237,3,240,191,49,27,2,71,115,14,0,6,2,1
X02,X02.1.1,397 | Maafushi Jail - 1,531,426,22,448,395,53,38,0,117,233,5,16,15,2,1
X02,X02.1.2,398 | Maafushi Jail - 2,475,309,33,342,320,22,13,2,80,160,6,25,22,1,1
X03,X03.1.1,399 | Asseyri Jail,377,315,17,332,314,18,18,2,119,106,7,2,58,3,1
X04,X04.1.1,400 | Dhoonidhoo Jail,143,124,6,130,124,6,17,0,22,85,0,0,0,0,1
YT.,YT.0.1,"569 | Hulhumale', Ehenihen - 1",622,517,4,521,235,286,18,0,166,292,7,9,25,0,1
YT.,YT.0.10,"578 | Hulhumale', Ehenihen - 10",576,457,2,459,175,284,17,1,163,217,8,7,35,9,1
YT.,YT.0.11,579 | Hulhumale' Ehenihen - 11,309,247,1,248,124,124,11,0,76,140,7,0,9,4,1
YT.,YT.0.12,"580 | Hulhumale', Ehenihen - 12",466,385,7,392,178,214,7,0,103,238,3,11,23,0,1
YT.,YT.0.13,"581 | Hulhumale', Ehenihen - 13",783,625,12,637,267,370,20,1,183,347,23,9,39,3,1
YT.,YT.0.14,"582 | Hulhumale', Ehenihen - 14",385,319,1,320,143,177,7,0,96,174,9,15,18,0,1
YT.,YT.0.15,"583 | Hulhumale', Ehenihen - 15",417,320,2,322,117,205,10,0,117,143,5,13,30,2,1
YT.,YT.0.16,"584 | Hulhumale', Ehenihen - 16",508,402,5,407,171,236,9,1,153,165,9,14,50,1,1
YT.,YT.0.17,"585 | Hulhumale', Ehenihen - 17",652,600,1,601,222,379,15,0,178,371,8,3,22,3,1
YT.,YT.0.2,"570 | Hulhumale', Ehenihen - 2",678,524,4,528,295,233,26,0,233,226,3,7,28,1,1
YT.,YT.0.20,"588 | Hulhumale', Ehenihen - 20",676,599,13,612,229,383,31,1,146,378,16,5,18,4,1
YT.,YT.0.25,"593 | Hulhumale', Ehenihen - 25",728,653,21,674,251,423,13,1,175,411,8,7,28,10,1
YT.,YT.0.29,"597 | Hulhumale', Ehenihen - 29",778,678,5,683,232,451,15,0,176,406,18,16,45,2,1
YT.,YT.0.3,"571 | Hulhumale', Ehenihen - 3",448,351,5,356,155,201,15,1,134,164,5,6,22,4,1
YT.,YT.0.33,"601 | Vilimale', Ehenihen - 1",780,606,10,616,241,375,28,0,210,305,8,11,33,11,1
YT.,YT.0.35,"603 | Vilimale', Ehenihen - 3",742,539,7,546,197,349,19,0,159,309,7,4,30,11,1
YT.,YT.0.4,"572 | Hulhumale', Ehenihen - 4",441,345,2,347,160,187,20,0,100,181,13,14,17,0,1
YT.,YT.0.5,"573 | Hulhumale', Ehenihen - 5",779,616,2,618,286,332,36,0,224,294,9,11,40,2,1
YT.,YT.0.7,"575 | Hulhumale', Ehenihen - 7",535,439,3,442,208,234,8,0,174,227,4,4,20,2,1
YT.,YT.0.8,"576 | Hulhumale', Ehenihen - 8",479,397,3,400,168,232,11,0,108,222,29,4,22,1,1
YT.,YT.0.9,"577 | Hulhumale', Ehenihen - 9",557,447,7,454,185,269,16,0,165,219,4,11,28,4,1
Z01,Z01.1.1,414 | JA Manafaru,40,0,0,0,0,0,0,0,0,0,0,0,0,0,0
Z03,Z03.1.1,416 | JW Marriott Maldives Resort & Spa,42,39,0,39,38,1,5,0,5,28,0,1,0,0,1
Z04,Z04.1.1,417 | Cheval Blanc Randheli,62,49,1,50,44,6,1,0,25,15,0,2,5,1,0
Z05,Z05.1.1,418 | Siyam World Maldives,81,75,0,75,65,10,4,0,38,30,0,2,0,1,1
Z06,Z06.1.1,419 | Sun Siyam Iru Fushi Maldives,80,70,4,74,69,5,2,0,47,17,0,1,3,0,1
Z08,Z08.1.1,421 | Robinson Noonu,38,24,1,25,22,3,2,0,8,9,1,0,4,0,1
Z09,Z09.1.1,422 | Dhigali Maldives,80,59,0,59,55,4,2,0,27,28,0,0,2,0,1
Z10,Z10.1.1,423 | You & Me By Cocoon,35,22,0,22,22,0,2,0,9,9,1,0,1,0,1
Z12,Z12.1.1,425 | Heritance Aarah,34,27,1,28,28,0,3,0,7,17,0,0,0,0,1
Z13,Z13.1.1,426 | Inter Continental Maldives Maamunagau,49,40,1,41,40,1,3,0,20,15,0,0,2,0,1
Z16,Z16.1.1,429 | Joali Muravandhoo,58,43,2,45,41,4,1,0,20,16,1,0,5,0,1
Z18,Z18.1.1,431 | Milaidhoo Island Maldives,57,50,0,50,46,4,4,0,24,14,2,1,5,0,1
Z19,Z19.1.1,432 | Royal Island Resort and Spa,75,66,0,66,63,3,4,0,17,17,25,0,2,1,1
Z20,Z20.1.1,433 | Vakkaru Maldives,57,52,0,52,48,4,1,0,21,25,2,0,2,1,1
Z21,Z21.1.1,434 | Amillafushi,40,35,0,35,29,6,3,0,17,13,0,0,2,0,1
Z22,Z22.1.1,435 | The Westin Maldives Miriandhoo Resort,41,39,2,41,35,6,1,0,14,22,0,0,2,0,1
Z23,Z23.1.1,436 | Finolhu Baa Atoll Maldives,60,52,1,53,44,9,3,0,26,19,0,0,4,0,1
Z24,Z24.1.1,437 | Reethi Beach Resort,36,31,0,31,31,0,1,0,17,8,3,0,0,2,1
Z25,Z25.1.1,438 | The Nautilus Maldives,47,40,0,40,34,6,5,0,15,15,0,0,5,0,1
Z26,Z26.1.1,439 | Kuredu Island Resort,39,35,1,36,35,1,3,0,9,21,0,0,2,0,1
Z28,Z28.1.1,441 | Atmosphere Kanifushi Maldives,35,32,0,32,27,5,2,0,12,11,0,0,7,0,1
Z31,Z31.1.1,444 | Malahini Kuda Bandos,45,38,0,38,32,6,4,0,12,15,3,0,3,1,1
Z32,Z32.1.1,445 | Paradise Island Resort and Spa,107,98,3,101,90,11,1,0,11,25,57,0,4,0,1
Z33,Z33.1.1,446 | Fihaalhohi Island Resort,66,57,1,58,56,2,3,1,23,26,0,1,3,0,1
Z34,Z34.1.1,447 | Huvafenfushi Maldives,56,50,0,50,46,4,0,0,27,21,0,0,2,0,1
Z35,Z35.1.1,448 | Velassaru Maldives,67,60,0,60,56,4,1,0,23,26,1,2,7,0,1
Z36,Z36.1.1,449 | Bandos Maldives,95,91,0,91,85,6,2,0,33,46,0,0,10,0,1
Z37,Z37.1.1,450 | Grand Park Kodhipparu Maldives,60,46,1,47,45,2,4,0,20,18,1,0,3,0,1
Z38,Z38.1.1,451 | Anantara Resort and Spa Maldives,96,80,0,80,78,2,5,0,29,35,2,0,9,0,1
Z39,Z39.1.1,452 | Sun Siyam Olhuveli Maldives,119,103,1,104,89,15,1,0,61,37,0,0,4,0,1
Z40,Z40.1.1,453 | Kurumba Maldives,103,89,0,89,84,5,7,0,27,44,1,1,9,0,1
Z41,Z41.1.1,454 | Taj Coral Reef Resort and Spa,77,62,0,62,58,4,7,0,15,32,1,0,7,0,0
Z42,Z42.1.1,455 | Jumeirah Maldives Olhahali Island,60,47,1,48,41,7,2,0,21,19,2,2,1,0,1
Z43,Z43.1.1,456 | Oblu Select by Atmosphere at Sangeli,34,32,1,33,31,2,1,0,13,15,0,0,2,1,1
Z44,Z44.1.1,457 | Holiday Inn Resort Kandooma Maldives,62,54,0,54,45,9,6,0,29,16,0,0,3,0,1
Z45,Z45.1.1,458 | Crossroads Maldives,84,66,0,66,60,6,7,0,24,28,1,3,2,1,1
Z46,Z46.1.1,459 | Cinnamon Dhonveli Maldives,46,41,0,41,39,2,0,0,12,27,0,0,2,0,1
Z47,Z47.1.1,"460 | Patina Maldives, Fari Islands",52,42,0,42,38,4,2,0,22,14,1,0,3,0,1
Z49,Z49.1.1,462 | Aanugandu Island Resort,33,31,0,31,26,5,3,0,14,12,0,0,2,0,1
Z50,Z50.1.1,463 | Adaaran Prestige Vadoo,34,32,0,32,31,1,2,0,6,22,0,0,2,0,1
Z51,Z51.1.1,464 | Sheraton Maldives Full Moon Resort & Spa,56,48,0,48,45,3,2,0,19,25,0,0,2,0,1
Z52,Z52.1.1,465 | Hilton Maldives Amingiri Resort & Spa,70,53,2,55,52,3,5,0,19,20,0,1,7,1,1
Z53,Z53.1.1,466 | Embudhu Village,43,43,0,43,41,2,0,0,15,22,0,1,4,1,1
Z54,Z54.1.1,467 | Gili Lankanfushi,65,62,0,62,59,3,1,0,24,33,1,0,3,0,1
Z55,Z55.1.1,468 | Waldorf Astoria Maldives Ithaafushi,126,113,0,113,111,2,4,0,39,52,1,0,17,0,1
Z56,Z56.1.1,469 | Oaga Art Resort,34,30,1,31,28,3,0,0,18,6,0,1,5,0,1
Z57,Z57.1.1,470 | Baros Maldives,56,53,2,55,50,5,2,0,18,25,0,0,8,0,1
Z58,Z58.1.1,471 | Kuda Villingili Resort Maldives,42,32,0,32,23,9,7,0,7,15,0,0,3,0,1
Z59,Z59.1.1,472 | Kuramathi Maldives,122,97,0,97,95,2,2,0,45,47,0,0,3,0,1
Z60,Z60.1.1,473 | W Maldives,46,37,1,38,36,2,3,1,18,13,0,0,2,0,1
Z61,Z61.1.1,474 | Conrad Maldives Rangali Island,94,91,0,91,89,2,1,0,37,32,2,1,18,0,0
Z62,Z62.1.1,475 | Sun Island Resort and Spa,115,105,3,108,97,11,1,0,11,16,76,0,1,0,0
Z63,Z63.1.1,476 | Nova Maldives,33,28,1,29,24,5,1,0,9,14,1,0,3,0,0
Z64,Z64.1.1,"477 | Lux South Ari Atoll, Maldives",65,60,0,60,53,7,1,0,30,25,1,0,2,1,0
Z66,Z66.1.1,479 | Radisson Blu Resort,33,25,1,26,23,3,2,0,8,13,0,1,1,0,0
Z69,Z69.1.1,482 | Niyama Maldives,51,45,0,45,44,1,4,0,20,18,0,0,2,1,0
Z70,Z70.1.1,483 | Kandima Maldives,60,49,2,51,48,3,2,0,21,21,1,0,1,3,0
Z71,Z71.1.1,"484 | The St. Regis Vommuli Resort, Maldives",52,48,0,48,47,1,3,0,18,21,1,0,4,1,0
Z73,Z73.1.1,486 | Riu Atoll and Riu Palace Maldivas,36,32,0,32,30,2,1,0,13,14,0,0,3,1,0
Z76,Z76.1.1,489 | Robinson Maldives,31,21,2,23,22,1,0,0,6,14,0,0,1,0,1
Z79,Z79.1.1,605 | One and Only Reethi Rah,160,147,0,147,146,1,4,0,89,38,0,0,15,1,1
Z80,Z80.1.1,606 | Fari Campus Maldives,88,80,0,80,72,8,2,0,32,38,1,1,6,0,1
Z81,Z81.1.1,607 | Amari Raaya Maldives,36,28,2,30,29,1,3,0,9,15,0,0,1,0,1
Z82,Z82.1.1,608 | Centara Ras Fushi Resort and Spa Maldives,35,23,0,23,19,4,0,0,13,7,1,0,2,0,1
Z83,Z83.1.1,609 | Centara Grand Island Resort and Spa Maldives,41,33,0,33,31,2,2,0,10,12,4,0,5,0,0
